GAAACAATTGAAGCCAAAGCCTTCCGCCGAACCTGAATTAAGTTTGAGAATAAAATCTTGGGGGG
GAGACAATTGAAGCCAAAGTCTCCCACCGAGCCAGAGCCCAGTTTGAAAACAAAATCTTGGGGGG
GAGACAATTGAAGCCAAAGTCTCCCACCGAGCCAGAGCCCAGTTTGAAAACAAAATCTTGGGGGG
GAGACAATTGAAGCCAAAGTCTCCCACCGAACCAGAGTCTAGTTTGAAAATAAAATCTTGGGGGG
GAGACAATTGAAGCCAAAGTCTCCCACCGAGCCAGAGCCCAGTTTGAAAACAAAATCTTGGGGGG
GAAACAATTGAAGCCAAAGTCTCCCACCGAGCCAGAACCCAGTTTGAAAACAAAATCTTGGGGGG
GAGACAGTTGAAGCCAAAGTCTCCCACCGAACCAAAGCCTAGTTTGAAAACAAAATCTTGGGGGG
GAAACAATTGAAGCCAAAGTCTCCCGCCGAACCTGAATTAAGTTTGAGAATAAAATCTTGAGGGG
GAGACAATTGAAGCCAAAGTCTCCCACCGAGCCAGAGCTCAGTTTGAAAACAGAATCTTGAAGGG
GAGACAATTGAAGCCAAAGTCTCCCGCCGAACCAGAATTGAGTTTGAGAACAAAATCTTGGGGGG
GAAACAATTGAAGCCAAAGTCTCCCGCCGAACCTGAATTAAGTTTGAGAATAAAATCTTGGGGGG
GAGACAATTGAAGCCAAAGTCTCCCGCCGAACCAGAATTGAGTTTGAGAACAAAATCTTGGGGGG
GAGACAATTGAAGCCAAAGTCTCCCACCGAGCCAGAGTCTAGTTTGAAAACAAAATCTTGGGGGG
GAGACAATTGAAGCCAAAGTCTCCCACCGAGCCAGAGCCCAGTTTGAAAACAAAATCTTGGGGGG
GAAACAATTGAAGCCAAAGTCTCCCACCGAACCTGAATTAAGTTTGAGAATAAAATCTCGGGGGG
GAGACAATTGAAGCCAAAGTCTCCCGCCGAACCAGAATTGAGTTTGAGAACAAAATCTTGGGGGG
GAGACAATTGAAGCCAAAGTCTCCCGCCGAACCAGAATTGAGTTTGAGAACAAAATCTTGGGGGG
GAGACAATTGAAGCCAAAGTCTCCCGCCGAACCAGAATTGAGTTTGAGAACAAAATCTTGGGGGG
GAAACAATTGAAGCCAAAGTCTCCCACCGAGCCAGAGCCCAGTTTGAAAACAAAATCTTGAAGGG
GAAACAATTGAAGCCAAAGCCTCCCGCCGAACCTGAATTAAGTTTGAGAATAGAATCTTGGGGGG
GAGACAATTGAAGCCAAAGTCTCCCACCGAACCAGAGTCTAGTTTGAAAACAAAATCTTGGAGGG
GAGACAATTGAAGCCAAAGTCTCCCACCGAACCAGAGTCTAGTTTGAAAACAAAATCTTGGAGGG
GAAACAATTGAAGCCAAAGTCTCCCACCGAACCTGAATTAAGTTTGAGAATAAAATCTTGGGGGG
GAAACAATTGAAGCCAAAGTCTCCCACCGAGCCAGAGCCCAGTTTGAAAACAAAATCTTGGGGGG
GAAGAAATTGAAATATATCTGTTCCAGCAACCCAAAATACCCTTCAAGAATAATACTTGGAGGGA
GAAGATGTTGAAATATATCTGTTCCAGCAGCCTAAAATCCCTTTCAAAAATAGCACTTAGAGGGA
GAAGATGTTGAAATATATCTGTTCCTGCAGCCTAAAATCCCTTTCAAAAATAGCACTTAGAGGGA
GAAGATGTTGAAATATATCTGTTCCTGCAGCCTAAAATCCCTTTCAAAAATAGCACTTAGAGGGA
GAAGATGTTGAAATATATCTGTTCCAGCAGCCTAAAATCCCTTTCAAAAATAGCACTTAGAGGGA
GAAGATGTTGAAATATATCTGTTCCTGCAGCCTAAAATCCCTTTCAAAAATAGCACTTAGAGGGA
GAAGATGTTGAAATATATCTGTTCCAGCAGCCTAAAATCCCTTTCAAAAATAGCACTTAGAGGGA
GAAGATGTTGAAATATATCTGTTCCAGCAGCCTAAAATCCCTTTCAAAAATAGCACTTAGAGGGA
GAAGATGTTGAAATATATCTGTTCCAGCAGCCTAAAATCCCTTTCAAAAATAGCACTTAGAGGGA
GAAGATGTTGAAATATATCTGTTCCAGCAGCCTAAAATCCCTTTCAAAAATAGCACTTAGAGGGA
GAAGATGTTGAAATATATCTGTTCCAGCAGCCTAAAATCCCTTTCAAAAATAGCACTTAGAGGGA
GAAGATGTTGAAATATATCTGTTCCAGCAGCCTAAAATCCCTTTCAAAAATAGCACTTAGAGGGA
GAAGAAATTGAAATATATCTGTTCCAGCAACCCAAAATACCCTTCAAGAATAATACTTGGAGGGA
GAAGATGTTGAAATATATCTGTTCCAGCAGCCTAAAATCCCTTTCAAAAATAGCACTTAGAGGGA
GAAGATGTTGAAATATATCTGTTCCTGCAGCCTAAAATCCCTTTCAAAAATAGCACTTAGAGGGA
GAAGATGTTGAAATATATCTGTTCCAGCAGCCTAAAATCCCTTTCAAAAATAGCACTTAGAGGGA
GAAGATGTTGAAATATATCTGTTCCTGCAGCCCAAAATCCCCTTCAAAAATAGCACTTAGAGGGA
GAAGATGTTGAAATATATCTGTTCCAGCAGCCTAAAATCCCTTTCAAAAATAGCACTTAGAGGGA
GAAGATGTTGAAATATATCTGTTCCAGCAGCCTAAAATCCCTTTCAAAAATAGCACTTAGAGGGA
GAAGATGTTGAAATATATCTGTTCCTGCAGCCCAAAATCCCCTTCAAAAATAGCACTTAGAGGGA
CATTGAAATGAAGTGAAAGTGTTCCTTTTTACCAGAACCAAGTTAAAAAACAGAATCCAGAAGGA
CATTGAAATGAAGTGAAAGTGTTCCTTTTTACCAGAACCAAGTTAAAAAACAGAATCCAGAAGGA
CATTGAAATGAAGTGAAAGTGTTCCTTTTTACCAGAACCAAGTTAAAAAACAGAATCCAGAAGGA
CATTGAAATGAAGTGAAAGTGTTCCTTTTTGCCAGAACCAAGTTAAAAAACAAAATCCAGAAGGA
CATTGAAATGAAGTGAAAGTGTTCCTTTCTACCAGAGCCAAGTTAAAAAACAAAATCCAGAAGGA
AGTACAATTACTGTGAAAATATTCTGTGAAATCAGGAC----CCGAAGGGTGAA------GGGAG
AGAAGTGGTTAAGAGGAAGCACTTTCGAAGAACAGGA-----TGTTAGGTCAAAACCCAACAGCA
AGAACAAGTGCAAAATGGGGGCTTCAGCGAAATCAAA-----AGAGGTGTAGATATGTTGATGCC
AACAGCACGCGCACAGGGAAATTTCACAGACATTGAG-----TTTTGGGACAATACATTCGGGCA
AAGAACACGCTTCTGTGGGAATTTTGTTGATATAGAA-----TATGGGGACAACACATCAAGGCC
TGGCTCATGCAGATGCGGCAATTTTACTGACATAGAA-----CTACGAGACAACACCTCAAAGCT
AGTCGCATTCAGATGTGGTAATTTCACTGATATAGAA-----CTTCGGGACAACATATCCAGGCT
AATCAGCGTCCGAGGTGGCAGCTTCAAGGACCAAGAA-----AAGAAGGAAGACATCTGAAGGCC
GCACGCGGACAGG---------------GATCCAAAAGAAGACTAACGAATACAACTCAAGGGAA
GATGACCACCACAAGAAACTTTTTGGTGGCCTCAGAGCCAGAATCAACGGGAGGGCTCT---GCA
AGTGTCGCTAAGTACAAATTTCTTAGTGAGATCAGAGCCCATCTTGAAGGAAGGGATCA---GCA
TGGATAATTAGAC---------------GGGAAAGGGCAACGTGTAAAGATAAGGGTCT---AAC
GTTCACCATCGATGTGAACTTCCTAATCGAGTCTGAACCACATTCAACGGGAGGGTTCT---GCC
AGTCAAATCCAAG---------------TCCACCAAA-----CATGAAAATAAAATAGT---GCT
GATGACACTAGACTCAAACTTCTTAATCGAATCTGAGCC---CTAGAAGGCAGAGTTCT---GCA
GGAGCCAACTGCATGGAATGGGTTGTGTAGAGCAGAATATCAGTAAAAGATCCAGGTCA---AGA
GGAGCCAGCTACAACGAATGGACTATCAAGGTCAGAGTTCCCTCTAAAAGTGTCGATCA---GAT
GGTGCCACCCACTAATAGCCGTTCCCTTAACCCCAGTTAGCTTAATATTATGGTAACCTTAGCCT
