TGGGATGGTCTTCAATCGTCTGATGATTTTGCTTTG-TTCGAGTCTCTGAAAC
TGGGATGGGCTCCAATCATCCGACGATTTTGCTCTC-TTCGAGTCTCTGAAAA
TGGGATGGGCTCCAATCATCCGACGATTTTGCTCTC-TTCGAGTCTCTGAAAA
TGGGATGGACTCCAATCCTCTGATGATTTCGCTCTC-TTCGAGTCTCTGAAAC
TGGGATGGGCTCCAATCATCCGACGATTTTGCTCTC-TTCGAGTCTCTGAAAA
TGGGATGGGCTCCAATCATCCGACGATTTTGCTCTC-TTCGAATCTCTGAAAA
TGGGACGGACTCCAATCCTCTGATGATTTCGCTCTC-TTCGAGCGTCTGAAAA
TGGGATGGACTCCAATCCTCTGATGATTTTGCTCTC-TTCGAGTCTCTAAAAC
TGGGATGGGCTCCAATCCTCTGATGATTTCGCTCTC-TTCGAGTCTCTGAAAC
TGGGATGGTCTTCAATCCTCTGACGATTTTGCTCTG-TTCGAGTCTCTGAAAC
TGGGACGGACTCCAATCCTCTGATGACTTCGCTCTC-TTCGAGTCTCTAAAAC
TGGGATGGTCTTCAATCCTCTGACGATTTTGCTCTG-TTCGAGTCTCTGAAAC
TGGGATGGACTCCAATCCTCTGATGATTTTGCTCTC-TTCGAGTCTCTGAAAC
TGGGATGGGCTCCAATCATCCGACGATTTTGCTCTC-TTCGAGTCTCTGAAAA
TGGGATGGGCTCCAATCCTCCGACGATTTTGCCCTC-TTCGAGTCTCTAAAAA
TGGGATGGTCTTCAATCCTCTGACGATTTTGCTCTG-TTCGAGTCTCTGAAAC
TGGGATGGTCTTCAATCCTCTGACGATTTTGCTCTG-TTCGAGTCTCTGAAAC
TGGGATGGTCTTCAATCCTCTGACGATTTTGCTCTG-TTCGAGTCTCTGAAAC
TGGGACGGACTCCAATCCTCAGATGACTTCGCCCTC-TTCGAGTCTCTGAAAC
TGGGATGGTCTTCAATCGTCTGATGATTTTGCTCTGTTTCGAGTCTCTAAAAC
TGGGACGGACTCCAATCCTCTGATGATTTCGCTCTC-TTCGAGTCACTGAAAC
TGGGACGGACTCCAATCCTCTGATGATTTCGCTCTC-TTCGAGTCACTGAAAC
TGGGATGGGCTCCAATCCTCCGACGATTTTGCCCTC-TTCGAGTCTCTAAAAA
TGGGATGGGCTCCAATCATCCGACGATTTTGCTCTC-TTCGAGTCTCTGAAAA
TGGGATGGACTGCAGTCTTCGGATGATTTTGCTCTGTTTCGAGCAGCTGAAAC
TGGGATGGACTGCAATCTTCTGATGATTTTGCTCTATTTCGAGCAGCTGAAAC
TGGGATGGACTGCAATCTTCCGATGATTTTGCTTTGTTTCGAGCAGCTGAAAC
TGGGATGGACTGCAATCTTCCGATGATTTTGCTTTGTTTCGAGCAGCTGAAAC
TGGGATGGACTGCAATCTTCTGATGATTTTGCTCTGTTTCGAGCAGCTGAAAC
TGGGATGGACTGCAATCTTCCGATGATTTTGCTTTGTTTCGAGCAGCTGAAAC
TGGGATGGACTGCAATCTTCTGATGATTTTGCTCTATTTCGAGCAGCTGAAAC
TGGGATGGACTGCAATCTTCTGATGATTTTGCTCTATTTCGAGCAGCTGAAAC
TGGGATGGACTGCAATCTTCTGATGATTTTGCTCTATTTCGAGCAGCTGAAAC
TGGGATGGACTGCAATCTTCTGATGATTTTGCTCTATTTCGAGCAGCTGAAAC
TGGGATGGACTGCAATCTTCTGATGATTTTGCTCTATTTCGAGCAGCTGAAAC
TGGGATGGACTGCAATCTTCTGATGATTTTGCTCTATTTCGAGCAGCTGAAAC
TGGGATGGACTGCAGTCTTCCGATGATTTTGCTCTGTTTCGAGCAGCTGAAAC
TGGGATGGACTGCAATCTTCTGATGATTTTGCTCTATTTCGAGCAGCTGAAAC
TGGGATGGACTGCAATCTTCTGATGATTTTGCTTTGTTTCGAGCAGCTGAAAC
TGGGATGGACTGCAATCTTCTGATGATTTTGCTCTATTTCGAGCAGCTGAAAC
TGGGATGGACTGCAATCTTCCGATGATTTTGCTTTGTTTCGAGCAGCTGAAAC
TGGGATGGACTGCAATCTTCTGATGATTTTGCTCTATTTCGAGCAGCTGAAAC
TGGGATGGACTGCAATCTTCTGATGATTTTGCTCTATTTCGAGCAGCTGAAAC
TGGGATGGACTGCAATCTTCCGATGATTTTGCTTTGTTTCGAGCAGCTGAAAC
TGGACTGGACTCCAATCTTCTGATGACTTTGTTCTT-CTGAAGTCGCTTAGAG
TGGACTGGACTCCAATCTTCTGATGACTTTGTTCTT-CTGAAGTCGCTTAGAG
TGGACTGGACTCCAATCTTCTGATGACTTTGTTCTT-CTGAAGTCGCTTAGAG
TGGACTGGACTCCAATCTTCTGATGACTTTGTTCTT-CTGAAGTCGCTTAGAG
TGGACTGGACTCCAATCTTCCGATGACTTCGTTCTT-CTGAAGTCGATTAGAG
CACCAGAAGCTGTGTACACATGACGACTTCGTTACA-CTGAAGTGCTACACAG
CAGGAGTACTGACAAAACA--GACGACTTTGTGACA-CTTGGATCTTTGGGCC
GGGGATGGACTGCAAAACTGTGACGACTCGATGACT-CTTGAGCGCCACATCA
TGGGATGGACTGTAAAACAGTGATGACTCTATGACC-TTGGAGTGCTATTTCA
TGGAATGGATTGCAAGACTGTGATGACTCAATGACT-CTGGAGTGCATTTTCA
TGGGATGGATTGCAAGACAGTGATGATTCCATGACT-----------------
TGGGATGGACTGTAAGACTGTGACGATTCCATGACTTCTTGAGCTGCCTCCTC
TCACAGTGACTGTAAAACAGTGACGACTCTATGAGT-TTGGAGTGTCGTAGAA
CAGAAGGAACTGTGCTGACTCGACGACTTCGTCACC-ATGGAATCCAGGAGTC
AAGAGATCACTGGAGACCATGGACGACTTTATTCAT-TTAAAATGTGGAATAC
CTGAAATTACAGGGGACCACGGACGATTTCATCCAC-TTGAAGTGCTCAATCC
CGGAGATAACTGGAGCACATGGATGACTTTATTCAC-TCAAAA----------
AGGAAATAACTGGTGATCATGGACGATTTTATCCAT-TTGAAATGTTGCATTT
TAGATATAAGAGGAAAACATGGATGATTTTATTCAT-TTTAAATGGCAAATAG
CAGAGTTAACCGGAGACCATGGACGACTTTATTCAT-CTCAAGTGTTCCATTC
AAGAGCTCACAGGATCGCACGGATGACTTCATCCAC-TCAAAA----------
CTGAGATTACTGGATCTCATGGATGATTTTATCCAC-TCGAAA----------
TGAGAGCGATATT--------TGTGACCTCAGTTCT-TCCGAA----------
-----------------------------------------------------
TGGACTGGGCTACAAAGTTCAGATGATTTTGTGCTCTTTTGCATCTCTAGGAC
-----------------------------------------------------
-----------------------------------------------------
-----------------------------------------------------
