ACCCACTGTGACTGGAATGGTAGATGGTGACATGAGGGCAGAAATCATAAAGAT
GCCTAACATGACAGGGATGGTAGATGGAGACATGCGAACAGAAGTTATAAGAAT
GCCTAACATGACAGGGATGGTAGATGGAGACATGCGAACAGAAGTTATAAGAAT
GCCCAACATGCAAGGCATGGTAGATGGTGACATGAGGACTGAAATCATAAGAAT
GCCTAAAATGACAGGGATGGTAGATGGAGACATGCGAACAGAAATTATAAGGAT
GCCTAAAATGACAGGGATGGTAGATGGAGACATGCGAACAGAGGTTATAAGAAT
GCCCAACATGCAGGGAATGGTAGATGGTGACATGAGGACTGAAATCATAAGGAT
ACCCTATATGGAGGGAATGATAGACGGTGACATGAGGGCAGAAATTATAAGGAT
GCCCAACATGCCAGGACTAGTCGCTGGCGACATGAGGACTGAAATCATAAGGAT
ACCCAATGTGACTGGAATGATAGATGGAGACATGAGGACCGAAATCATAAGGAT
ACCCTATATGCAAGGAATGGTTGATGGTGACATGAGGGCAGAAATCATAAGGAT
ACCCAATGTGACTGGAATGATAGATGGAGACATGAGGACCGAAATCATAAGGAT
GCCCAACATGCAAGGCATGGTAGATGGTGACATGAGGACTGAAATCATAAGAAT
GCCTAACATGACAGGGATGGTAGATGGAGACATGCGAACAGAAGTTATAAGAAT
ACCTTATATGGAGGGAATGGTAGACGGTGACATGAGGGCAGAAATCATAAGAAT
ACCCAATGTGACTGGAATGATAGATGGAGACATGAGGACCGAAATCATAAGGAT
ACCCAATGTGACTGGAATGATAGATGGAGACATGAGGACCGAAATCATAAGGAT
ACCCAATGTGACTGGAATGATAGATGGAGACATGAGGACCGAAATCATAAGGAT
GCCCAACATGGAAGGCCTAATTGATGGTGACATGAGGACTGAAATCATAAGAAT
ACCCTCTGTGACTGGAATGATAGATGGAGACATGAGGGCAGAAATCATAAAGAT
GCCCAACATGCAGGGAATGGTAGATGGTGACATGAGGACTGAAATCATAAGAAT
GCCCAACATGCAGGGAATGGTAGATGGTGACATGAGGACTGAAATCATAAGAAT
ACCTTATATGGAGGGAATGGTGGATGGTGACATGAGGGCAGAAATCATAAGAAT
GCCTAAAATGACAGGGATGGTAGATGGAGACATGCGAACAGAAGTTATAAGAAT
ACCCAATATGGAAGGAATGATTGCAGGTGATGTCAAAGGAAATCTACTCAAAAT
ACCCAATATGGAAGGAATGATTGCAGGTGATGTCAAAGGAAATCTACTCAAGAT
ACCCAATATGGAAGGAATGATTGCAGGTGATGTCAAAGGAAATCTACTCAAGAT
ACCCAATATGGAAGGAATGATTGCAGGTGATGTCAAAGGAAATCTACTCAAGAT
ACCCAATATGGAAGGAATGATTGCAGGTGATGTCAAAGGAAATCTACTCAAGAT
ACCCAATATGGAAGGAATGATTGCAGGTGATGTCAAAGGAAATCTACTCAAGAT
ACCCAATATGGAAGGAATGATTGCAGGTGATGTCAAAGGAAATCTACTCAAGAT
ACCCAATATGGAAGGAATGATTGCAGGTGATGTCAAAGGAAATCTACTCAAGAT
ACCCAATATGGAAGGAATGATTGCAGGTGATGTCAAAGGAAATCTACTCAAGAT
ACCCAATATGGAAGGAATGATTGCAGGTGATGTCAAAGGAAATCTACTCAAGAT
ACCCAATATGGAAGGAATGATTGCAGGTGATGTCAAAGGAAATCTACTCAAGAT
ACCCAATATGGAAGGAATGATTGCAGGTGATGTCAAAGGAAATCTACTCAAGAT
ACCCAATATGGAAGGAATGATTGCAGGTGATGTCAAAGGAAATCTACTCAAAAT
ACCCAATATGGAAGGAATGATTGCAGGTGATGTCAAAGGAAATCTACTCAAGAT
ACCCAATATGGAAGGAATGATTGCAGGTGATGTCAAAGGAAATCTACTCAAGAT
ACCCAATATGGAAGGAATGATTGCAGGTGATGTCAAAGGAAATCTACTCAAGAT
ACCCAATATGGAAGGAATGATTGCAGGTGATGTCAAAGGAAATCTACTCAAGAT
ACCCAATATGGAAGGAATGATTGCAGGTGATGTCAAAGGAAATCTACTCAAGAT
ACCCAATATGGAAGGAATGATTGCAGGTGATGTCAAAGGAAATCTACTCAAGAT
ACCCAATATGGAAGGAATGATTGCAGGTGATGTCAAAGGAAATCTACTCAAGAT
CCCATACATTGGA----------------AAATAAAGTTCAAGCTCATGAAGAT
CCCATACATTGGA----------------AAATAAAGTTCAAGCTCATGAAGAT
CCCATACATTGGA----------------AAATAAAGTTCAAGCTCATGAAGAT
CCCATACATTGGA----------------AAATAAAGTTCAAGCTCATGAAGAT
CCCATACATTGGA----------------AAATAAAGTTCAAGCTCATGAAGAT
----------------------------GACGAGGAAGAGGAAGACATTGACAT
GTGGCATCA-----------------GGGGAAAACAGGGGCAAGCAGCGAACAT
TATCGATCT-------------------GTGTCAAAGAAAGCCCTGATGGCAAT
TGTGGACATGCAATGAAATAATCTTGGAGTCGTGAAGGAGAAATTGAAAAGCAT
CCTGGACATGAAACAAACTGCTGTTGAGGTCGTGAAGGAAGAACTAAAGAAAGT
TATAGACATGGTCTATTCTCTCCCTTGAGTGAACAAAGAAGAACTGAAGGGAGT
TCTGGATATGAAACACACTCCTTCTGGAGATGAGGAGGAAGAGCCACTAGAAAA
CCTGGACATGGGAAGAAATAACTTTGGAGAGGACGAAAATGAACCAATCAATTT
--CTGATGTGAAAACCCTGAATCTGACGGTTGTTGACTGAAAACTATGTAATGA
CCAAGTGGT--------------------ACAACGAATGGGAAATGAAAGAGGT
TCAGTCAAT--------------------AAGATGGATGGAAGCTAAGAGAAGT
CCAGGAAGTGTGAGACAC----------GGAAGTGAGTGGAAGTATACCGCTGT
CCAGAATAT--------------------AGGGAAAGTATGAACTTAGAGAGAC
CAGCACTGTTTA----------------TACCAAAAAGAGAGACTACTAAATAT
TCAGAACAT--------------------AAGGAAGATTCGAGTTACGCGAGAC
CCAAGAGGC-------------------GAAGTTATGACCG---AAGTGGAGAT
CCAAGAAAT-------------------GCTTTTGAATACGTTCCCGTAGAAAT
-----------------------------GCGAGAGGTAAAATTTGGGCAAATC
------------------------------------------------------
------------------------------------------------------
------------------------------------------------------
------------------------------------------------------
TCTGGATGTGAAACAGATCCCTTCTGGAGAAGAGAAGGCGCAACTACTGGAGAG
