TACCGGCTTTCACCATAACCGGAGTGGGTGAGGGAACTCGCATTACAGCTAT
TACCTGCTTTCACAATCACTGGAGTGGATGAGAGAACTCACCTTACAACTAC
TACCTGCTTTCACAATCACTGGAGTGGATGAGAGAACTCACCTTACAACTAC
TACCAGCCTTTACAATTACTGGAATGGATGAGAGAGCTGACCTTACAACTAT
TACCTGCTTTCACAATCACTGGAATGGATGAGAGAACTCACCTTACAACTAC
TACCTGCTTTCACAATCACTGGAGTGGATGAGAGAACTCACCTTACAACTAC
TACCTGCTTTTACAATTACTGGAATGGGTGAGAGAGCTGACATTGCAACTCT
TACCTGCTTTCACAATTACTGGAGTGGATGAGGGAACTCGCCTTACAGCTAC
TACCTGCCTTTACAGTTACCGGAATGGGTGAGAGAGCTGACCTTACAACTAT
TGCCAGCTTTCACCATCACTGGAGTGGATGAGAGAACTCACCTTACATCTAT
TACCTGCTTTCACAATTACTGGAGTGGATGAGGGAACTCGCCTTACAGCTAC
TGCCAGCTTTCACCATCACTGGAGTGGATGAGAGAACTCACCTTACATCTAT
TACCTGCCTTTACAATTACTGGAATGGATGAGAGAGCTGACCTTACAACTAT
TACCTGCTTTCACAATCACTGGAGTGGATGAGAGAACTCACCTTACAACTAC
TACCTGCTTTCACAATCACTGGAATGGATGAGGGAACTCGCATTACAACTGC
TGCCAGCTTTGACCATCACTGGAGTGGATGAGAGAACTCACCTTACATCTAT
TGCCAGCTTTCACCATCACTGGAGTGGATGAGAGAACTCACCTTACATCTAT
TGCCAGCTTTCACCATCACTGGAGTGGATGAGAGAACTCACCTTACATCTAT
TACCTGCCTTCACAATTACTGGAATGGGTGAGAGAGCTGACCTTACAACTAT
TACCAACTTTCACCATCACTGGAGTGGATGAGGGAACTCGCCTTACAGCTAT
TGCCTGCCTTTACAATTACTGGAATGGGTGAGAGAGCTAACCTTACAACTAC
TACCTGCCTTTACAATTACTGGAATGGGTGAGAGAGCTAACCTTACAACTAC
TACCTGCTTTCACAATCACTGGAATGGATGAGGGAACTCGCATTACAACTGC
TACCTGCTTTCACAATCACTGGAATGGACGAGAGAACTCACCTTACAACTAC
TACCCGGTATGACTGTGACAGGAAGAGATGATAAAACCATTACTGGAAACAT
TACCCGGCATGACAGTAACAGGAAGAGATGATAAAACCATTATTAGAAACAT
TACCTGGCATGACAGTAACAGGAAGAGATGATAAAACCATTATTAGAAACAT
TACCTGGCATGACAGTAACAGGAAGAGATGATAAAACCATTATTAGAAACAT
TACCCGGCATGACAGTAACAGGAAGAGATGATAAAACCATTATTAGAAACAT
TACCTGGCATGACAGTAACAGGAAGAGATGATAAAACCATTATTAGAAACAT
TACCCGGCATGACAGTAACAGGAAGAGATGATAAAACCATTATTAGAAACAT
TACCCGGCATGACAGTAACAGGAAGAGATGATAAAACCATTATTAGAAACAT
TACCTGGCATGACAGTAACAGGAAGAGATGATAAAACCATTATTAGAAACAT
TACCCGGCATGACAGTAACAGGAAGAGATGATAAAACCATTATTAGAAACAT
TACCCGGCATGACAGTAACAGGAAGAGATGATAAAACCATTATTAGAAACAT
TACCCGGCATGACAGTAACAGGAAGAGATGATAAAACCATTATTAGAAACAT
TACCCGGTATGACTGTGACAGGAAGAGATGATAAAACCATTACTGGAAACAT
TACCCGGCATGACAGTAACAGGAAGAGATGATAAAACCATTATTAGAAACAT
TACCTGGCATGACAGTAACAGGAAGAGATGATAAAACCATTATTAGAAACAT
TACCCGGCATGACAGTAACAGGAAGAGATGATAAAACCATTATTAGAAACAT
TACCTGGCATGACAGTAACAGGAAGAGATGATAAAACCATTATTAGAAACAT
TACCCGGCATGACAGTAACAGGAAGAGATGATAAAACCATTATTAGAAACAT
TACCCGGCATGACAGTAACAGGAAGAGATGATAAAACCATTATTAGAAACAT
TACCTGGCATGACAGTAACAGGAAGAGATGATAAAACCATTATTAGAAACAT
GTCTTGCAGTTAATATAACTGGAGTTGTTGAATTGACAAGTTATATAATTGT
GTCTTGCAGTTAATATAACTGGAGTTGTTGAATTGACAAGTTATATAATTGT
GTCTTGCAGTTAATATAACTGGAGTTGTTGAACTGACAAGTTATATAATTGT
GTCTTGCAGTTAATATAACTGGAGTTGTTGAATTGACAAGTTATATAATTGT
GTCTTGCAGTTAATATAACTGGAGTTGTTGAATTAACAAGTTATATAATTGT
GACTTGTAGTGACACTCACAGGTGGGAATGAAGAGGAT--------------
ACAACATAGTCGCACTGACAGGAACAGAAGGGATGGGCGTTCTGTGATGTGT
TTAGTCTAATACAAGCAACAGA------------------TCCGAGAACTGA
TCCACCACTTGCAGGCCACTGACAAGATTGGGAGGGATGGA-----------
TCCACCACCTCCAAGCCACTGACAGGATTGGGAGGGGTGG------------
TCCACCATATCCAGGCGACCGACAAGACTGGGAGGGATGG------------
TGCACAATATCCAGGCCACTGACAGGATTGGGAGGGGTGGTCCAAGCAATAC
TTAGTCACACCCAAGCCACTGACAGGATTGGGAAGGATGGTGCGACTGCTGC
TCCTTACGGTGAGCCTGACAGGCAAGAGAAGGAGAGTTGATTTATTGATAGA
TCCACACAGGTGAACTGAGTGG--------GGATGGTTGGCCTTCTTAGAGA
TCCACACTGGGGAGCTGAGTGG--------AGAAGGCTGGCCTCATCAGGGA
TCCATCCCGGAGAATTAAGTGGGAAGATGAAGAAGGATGGTTTCAGAATCTG
TTCACCCAGGAGAGCTAAGTGG--------GGAAGGTTGGCCTATTGAGAGA
ACAATGCTGGAGAATTAAGCGGAGAGATGCACCAGGATGGTTTGTGGATTGT
TTCATACTGGAGAATTAAGTGG--------AGAGGGTTGG------------
TTCACACAGGAGAGCTGAGCGGCAGTCAGAAGATGGTTGGTTTTTCAGATGG
TCCATCCAGGAGAACTAAGTGGGAAGATGAAGAGGGGTGGTTTTTCTGCTG-
TTCCTCTCATTATCTGCACTCGATGAGCTGGTGACGCTTTTCTTCCAACTTC
